***************
*S* *  * *  * *
* * *         *
* *   **   *  *
* *   **  *   *
* *   *   *** *
*    *G    *  *
***************
