***************
*S* *  * *  * *
* * *         *
* *   **   *  *
* *   **  *   *
* *   * ***** *
*    *G       *
***************
