********
*S* *  *
* * * G*
*     **
********
